###################################################################################################
#.................................................................................................#
#.......u.........................................................................................#                                                                         
#.................................................................................................# 
#.................................................................................................#
#.................................................................................................#
#.................................................................................................#
#.................................................................................................#
#.............SSSSSSSSSSSSSSSSSSSSSSSSSSSSSSSSSSSSSSSSSSSSSSSSSSSSSSSSSSSSS.......................#
#.................................................................................................#
#.................................................................................................#
#.................................................................................................#
#.................................................................................................#
#.................................................................................................#
#.................................................................................................#
#.................................................................................................#
#.................................................................................................#
#.................................................................................................#
#.................................................................................................#
#.................................................................................................#
#.................................................................................................#
###################################################################################################