##########    #############
#........#    #...........#
#........#    #...........#
#........######......d....#
#.s......|....|...........#
#........######...........#
#.....h..#    #...........#
#........#    #...........#
####|#####    ######|######
   #.#             #.#
   #.#             #.#
   #.#             #.#
   #.#             #.#
   #|###############|#######
   #@.........~~~~~........#
   #..........~~~~~........#
   #..........~~~~~........#
   #..........~~~~~........#
   #..........~~~~~.S......#
   #..........~~~~~........#
   #..........~~~~~........#
   #..........~~~~~........#
   #..........~~~~~........#
   #..........~~~~~........#
   #.......................#
   #########################