###########################
#.............#...........#
#.............#...........#
#.............#......d....#
#.s...........|...........#
#.............#...........#
#.....h.......#...........#
#........S....#...........#
####|####G#########|#######
   #@.........~~~~~........#
   #..........~~~~~........#
   #..........~~~~~........#
   #..........~~~~~........#
   #..........~~~~~.S......#
   #..........~~~~~........#
   #..........~~~~~........#
   #..........~~~~~........#
   #..........~~~~~........#
   #..........~~~~~........#
   #.......................#
   #########################