##########    #############
#........#    #...........#
#........#    #...........#
#........######...........#
#...P....|....|...........#
#........######...........#
#........#    #...........#
#........#    #...........#
####|#####    ######|######
   #.#             #.#
   #.#             #.#
   #.#             #.#
   #.#             #.#
   #|###############|#######                                                                        ########################
   #.......................#                                                                        #......................#
   #.......................#                                                                        #......................#
   #.......................##########################################################################......................#
   #.......................|...............................................................................................#
   #.......................##########################################################################......................#
   #.......................#                                                                        #......................#
   #.......................#                                                                        #......................#
   #########################                                                                        ########################